0 0 0 0 0 0 0 0 0 0 0 0 0 0 0 0 0 3 3 3 3 3 3 3 3 3 3 3 3 3 3 3 3 3 3 3 3 3 3 3 3 3 3 3 3 3 3 3 3 3 3 3 3 3 3 3 3 3 3 3 3 3 3 3 3 3 3 3 3 3 3 3 3 3 3 3 3 3 3 3 3 3 3 3 0 0 0 0 0 0 0 0 0 0 0 0 0 0 0 0 
0 0 0 0 0 0 0 0 0 0 0 0 3 3 3 3 3 3 3 3 3 3 3 3 3 3 3 3 3 3 3 3 3 3 3 3 3 3 3 3 3 3 3 3 3 3 3 3 3 3 3 3 3 3 3 3 3 3 3 3 3 3 3 3 3 3 3 3 3 3 3 3 3 3 3 3 3 3 3 3 3 3 3 3 0 0 0 0 0 0 0 0 0 0 0 0 0 0 0 0 
0 3 3 3 3 3 3 3 3 3 3 3 3 3 3 3 3 3 3 3 3 3 3 3 3 3 3 3 3 3 3 3 3 3 3 3 3 3 3 3 3 3 3 3 3 3 3 3 3 3 3 3 3 3 3 3 3 3 3 3 3 3 3 3 3 3 3 3 3 3 3 3 3 3 3 3 3 3 3 3 3 3 3 3 3 3 3 3 0 0 0 0 0 0 0 0 0 0 0 0 
3 3 3 3 3 3 3 3 3 3 3 3 3 3 3 3 3 3 3 3 3 3 3 3 3 3 3 3 207 206 206 206 206 206 206 206 206 206 206 206 205 3 3 3 3 3 3 3 3 3 3 3 3 3 3 3 3 3 3 3 3 3 3 3 3 3 3 3 3 3 3 3 3 3 3 3 3 3 3 3 3 3 3 3 3 3 3 3 3 3 3 3 3 3 0 0 0 0 0 0 
3 3 3 3 3 3 3 3 3 3 3 3 3 3 3 3 3 3 3 3 3 3 3 3 3 3 3 3 201 265 265 265 265 265 265 265 265 265 265 265 201 3 3 3 3 3 3 3 3 3 3 3 3 3 3 3 3 3 3 3 3 3 3 3 3 3 3 3 3 3 3 3 3 3 3 3 3 3 3 3 3 3 3 3 3 3 3 3 0 0 0 3 0 0 0 0 0 0 0 0 
3 3 3 3 3 3 3 3 3 3 3 3 3 3 3 3 3 3 3 3 3 3 3 3 3 3 3 3 201 265 265 265 265 265 265 265 265 265 265 265 201 3 3 3 3 3 3 3 3 3 3 3 3 3 3 3 3 3 3 3 3 3 3 3 3 3 3 3 3 3 3 3 3 3 3 3 3 3 3 3 3 3 3 3 3 3 3 3 0 0 3 0 0 0 0 0 0 0 0 0 
3 3 3 3 3 3 3 3 3 3 3 3 3 3 3 3 3 3 3 3 3 3 3 3 3 3 3 3 201 265 265 265 265 265 265 265 265 265 265 265 201 3 3 3 3 3 3 3 3 3 3 3 3 3 181 206 206 206 206 206 206 206 205 3 3 3 3 3 3 3 3 3 3 3 3 3 3 3 3 3 3 3 3 3 3 3 3 3 0 3 3 0 0 3 3 3 0 0 0 0 
3 3 3 3 3 3 3 3 3 3 3 3 3 3 3 3 3 3 3 3 3 3 3 3 3 3 3 3 201 265 265 265 265 265 265 265 265 265 265 265 201 3 3 3 3 3 3 3 3 3 3 3 3 3 183 265 265 265 265 265 265 265 201 3 3 3 3 3 3 3 3 3 3 3 3 3 3 3 3 3 3 3 3 3 3 3 3 3 3 3 3 3 3 3 3 3 0 0 0 0 
3 3 3 3 3 3 3 3 3 3 3 3 3 3 3 3 3 3 3 3 3 3 3 3 3 3 3 3 201 265 265 265 265 265 265 265 265 265 265 265 201 3 3 3 3 3 3 3 3 3 3 3 3 3 183 265 265 265 265 265 265 265 201 3 3 3 3 3 3 3 3 3 3 3 3 3 3 3 3 3 3 3 3 3 3 3 3 3 3 3 3 3 3 3 3 0 0 0 0 0 
3 3 3 3 3 3 3 3 3 3 3 3 181 179 179 179 179 179 179 179 179 179 179 179 179 179 179 179 184 265 265 265 265 265 265 265 265 265 265 265 201 3 3 3 3 3 3 3 3 3 3 3 3 3 183 265 265 265 265 265 265 265 201 3 3 3 3 3 3 3 3 3 3 3 3 3 3 3 3 3 3 3 3 3 3 3 3 3 3 3 3 3 3 3 3 0 0 0 0 0 
3 3 3 3 3 3 3 3 3 3 3 3 183 265 265 265 265 265 265 265 265 265 265 265 265 265 265 265 265 265 265 265 265 265 265 265 265 265 265 265 201 3 3 3 3 3 3 3 3 3 3 3 3 3 183 265 265 265 265 265 265 265 201 3 3 3 3 3 3 3 3 3 3 3 3 3 3 3 3 3 3 3 3 3 3 3 3 3 3 3 3 3 3 0 0 0 0 0 0 0 
3 3 3 3 3 3 3 3 3 3 3 3 183 265 265 265 265 265 265 265 265 265 265 265 265 265 265 265 265 265 265 265 265 265 265 265 265 265 265 265 201 3 3 3 3 3 3 3 3 3 3 3 3 3 201 265 265 265 265 265 265 265 201 3 3 3 3 3 3 3 207 206 206 206 206 206 206 206 206 206 123 120 3 3 3 3 3 3 3 3 3 3 3 0 0 0 0 0 0 0 
3 3 3 3 3 3 3 3 3 3 3 3 183 265 265 265 265 265 265 265 265 265 265 265 265 265 265 265 265 265 265 265 265 265 265 265 265 265 265 265 201 3 3 3 3 3 3 3 3 3 3 3 3 3 201 265 265 265 265 265 265 265 201 3 3 3 3 3 3 3 201 265 265 265 265 265 265 265 265 265 265 121 123 3 3 3 3 3 3 3 3 3 3 0 0 0 0 0 0 0 
3 3 3 3 3 3 3 3 3 3 3 3 183 265 265 265 265 265 265 265 265 265 265 265 265 265 265 265 265 265 265 265 265 265 265 265 265 265 265 265 201 3 3 3 3 3 3 3 3 3 3 3 3 3 201 265 265 265 265 265 265 265 201 3 3 3 3 3 3 3 201 265 265 265 265 265 265 265 265 265 265 265 123 121 123 3 3 3 3 3 3 3 3 3 0 0 0 0 0 0 
3 3 3 3 3 3 3 3 3 3 3 3 183 265 265 265 265 265 265 265 265 265 265 265 265 265 265 265 265 265 265 265 265 265 265 265 265 265 265 265 200 206 206 206 206 206 206 206 206 206 206 206 206 206 210 265 265 265 265 265 265 265 200 206 206 206 206 206 206 206 210 265 265 265 265 265 265 265 265 265 265 265 265 121 123 3 3 3 3 3 3 3 3 3 0 0 0 0 0 0 
3 3 3 3 3 3 3 3 3 3 3 3 183 265 265 265 265 265 265 265 265 265 265 265 265 265 265 265 265 265 265 265 265 265 265 265 265 265 265 265 265 265 265 265 265 265 265 265 265 265 265 265 265 265 265 265 265 265 265 265 265 265 265 265 265 265 265 265 265 265 265 265 265 265 265 265 265 265 265 265 265 265 265 123 120 120 123 3 3 3 3 3 3 0 0 0 0 0 0 0 
3 3 3 3 3 3 3 3 3 3 3 3 183 265 265 265 265 265 265 265 265 265 265 265 265 265 265 265 265 265 265 265 265 265 265 265 265 265 265 265 265 265 265 265 265 265 265 265 265 265 265 265 265 265 265 265 265 265 265 265 265 265 265 265 265 265 265 265 265 265 265 265 265 265 265 265 265 265 265 265 265 265 265 265 121 121 123 3 3 3 3 3 3 3 3 3 0 0 0 0 
3 3 3 3 3 3 3 3 3 3 3 3 183 265 265 265 265 265 265 265 265 265 265 265 265 265 265 265 265 265 265 265 265 265 265 265 265 265 265 265 265 265 265 265 265 265 265 265 265 265 265 265 265 265 265 265 265 265 265 265 265 265 265 265 265 265 265 265 265 265 265 265 265 265 265 265 265 265 265 265 265 265 265 265 123 120 120 3 3 3 3 3 3 3 3 3 3 0 0 0 
3 3 3 3 3 3 3 3 3 3 120 123 183 265 265 265 265 181 179 179 179 179 179 179 179 179 179 179 178 265 265 265 265 265 265 265 265 265 265 181 179 179 179 179 179 179 179 179 179 179 179 179 179 179 179 179 179 179 179 179 179 179 179 179 179 179 179 179 179 179 179 179 179 179 179 179 179 179 179 179 179 179 179 179 176 120 123 3 3 3 3 3 3 3 3 3 3 0 0 0 
3 3 3 3 3 3 3 3 3 120 120 123 185 179 179 179 179 184 171 194 171 194 171 171 171 192 192 171 183 265 265 265 265 265 265 265 265 265 265 183 265 265 265 265 265 265 265 265 265 265 265 265 265 265 265 265 265 265 265 265 265 265 265 265 265 265 265 265 265 265 265 265 265 265 336 332 332 332 332 332 332 332 332 332 334 123 121 121 3 3 3 3 3 3 3 3 3 0 0 0 
3 3 3 3 3 3 3 3 120 120 123 120 193 171 171 194 171 171 172 172 194 172 172 192 172 172 172 172 183 265 265 265 265 265 265 265 265 265 265 183 265 265 265 265 265 265 265 265 265 265 265 265 265 265 265 265 265 265 265 265 265 265 265 265 265 265 265 265 265 265 265 265 265 265 337 340 330 330 330 330 330 330 330 330 339 394 1 120 123 3 3 3 3 3 3 3 3 0 0 0 
3 3 3 3 3 3 3 3 120 120 120 120 172 191 191 172 194 194 188 188 188 188 188 188 188 188 188 188 185 179 179 179 179 179 179 179 179 179 179 177 179 179 179 179 179 179 179 179 178 265 265 265 265 265 265 265 265 265 265 265 265 265 265 265 265 265 265 265 265 265 265 265 265 265 265 337 338 338 338 338 338 338 330 330 339 394 1 1 123 3 3 3 3 3 3 3 3 0 0 0 
3 3 3 3 3 3 3 3 120 123 123 120 188 188 188 188 188 188 188 188 188 188 188 188 188 188 188 188 171 192 192 171 171 171 401 402 407 405 399 171 171 171 171 171 194 171 171 171 183 265 265 265 265 265 265 265 265 265 265 265 265 265 265 265 265 265 265 265 265 265 265 265 265 265 265 265 265 265 265 265 265 265 331 330 342 334 394 1 123 121 3 3 3 3 3 3 3 0 0 0 
3 3 3 3 3 3 3 3 120 123 120 120 188 188 188 188 188 188 188 188 188 188 188 188 188 188 188 188 172 172 172 172 172 194 322 403 404 406 322 172 172 194 172 172 172 172 191 172 185 179 179 179 179 179 179 179 179 179 179 179 179 179 179 179 179 179 179 179 179 179 179 179 179 179 179 179 179 179 179 179 179 179 331 330 330 339 394 1 1 120 3 3 3 3 3 3 3 3 0 0 
3 3 3 3 3 3 3 3 120 123 123 120 188 188 188 188 188 188 188 188 188 188 188 188 188 188 188 188 188 188 316 315 315 315 317 188 310 188 188 188 188 188 188 188 188 188 188 188 171 192 192 171 171 192 171 171 171 171 194 194 171 171 171 171 171 192 171 171 171 192 171 171 171 171 171 171 191 193 171 171 171 171 331 330 330 339 394 1 1 120 123 3 3 3 3 3 3 3 0 0 
3 3 3 3 3 3 3 3 120 121 123 0 188 188 188 188 188 188 188 188 188 188 188 188 188 188 188 188 188 188 314 320 311 320 313 188 309 188 188 188 188 188 188 188 188 188 188 188 172 172 172 172 191 172 191 172 172 172 172 172 191 193 172 172 172 172 194 172 192 172 194 172 172 194 194 172 172 172 192 172 192 172 331 330 330 339 394 1 1 1 123 3 3 3 3 3 3 3 0 0 
3 3 3 3 3 3 3 120 120 121 121 120 188 188 188 188 188 188 188 188 188 188 188 188 188 188 188 188 188 188 314 311 320 311 313 188 309 188 316 315 315 315 315 317 188 188 188 188 188 188 188 188 188 188 188 188 188 188 188 188 188 188 188 188 188 188 188 188 188 188 188 188 188 188 188 188 188 188 188 188 188 393 331 330 330 339 394 1 1 1 121 3 3 3 3 3 3 3 0 0 
3 3 3 3 3 3 3 3 120 123 121 120 188 188 188 188 188 188 188 188 188 188 188 188 188 188 188 188 188 188 188 312 312 312 319 188 309 188 314 311 320 311 320 313 188 188 316 315 315 315 315 315 317 188 316 315 315 315 315 315 315 315 315 317 316 315 315 315 315 317 188 188 188 393 393 393 393 393 393 393 393 393 331 330 330 339 394 1 1 123 121 3 3 3 3 3 3 3 0 0 
3 3 3 3 3 3 3 3 123 123 121 120 188 188 188 188 188 188 188 188 188 188 188 188 188 188 188 188 188 188 316 315 315 315 317 188 309 188 314 320 311 320 311 313 188 188 314 320 311 311 320 311 313 188 314 320 311 320 311 320 311 320 311 313 314 311 320 320 311 313 188 188 188 375 372 372 372 372 372 372 372 378 330 330 330 339 394 1 1 120 123 3 3 3 3 3 3 3 0 0 
3 3 3 3 3 3 3 3 120 123 123 120 188 188 188 188 188 188 188 188 188 188 188 188 188 188 188 188 188 188 314 311 320 311 313 188 309 188 314 311 320 311 320 313 188 188 314 311 320 311 311 311 313 188 314 311 320 311 320 311 320 311 320 313 314 320 311 311 320 313 188 310 188 376 373 373 373 373 373 373 373 379 330 330 330 339 394 1 1 123 3 3 3 3 3 3 3 3 0 0 
3 3 3 3 3 3 3 3 120 120 120 120 188 188 188 188 188 188 188 188 188 188 188 188 188 188 188 188 188 188 314 320 311 320 313 188 309 188 318 312 312 312 312 319 188 188 318 312 312 311 320 311 313 188 314 320 311 320 311 320 311 320 311 313 314 311 320 320 311 313 188 309 188 377 374 374 374 380 380 374 380 380 330 330 330 339 394 1 1 121 3 3 3 3 3 3 3 0 0 0 
3 3 3 3 3 3 3 3 3 120 123 120 188 188 188 188 188 188 188 188 188 188 188 188 188 188 188 188 188 188 318 312 312 312 319 188 309 188 188 188 188 188 188 188 188 188 188 188 188 312 312 312 319 188 318 312 312 312 312 312 312 312 312 319 318 312 312 312 312 319 188 309 188 393 393 393 393 393 393 393 393 393 331 330 330 339 394 1 123 120 3 3 3 3 3 3 3 0 0 0 
3 3 3 3 3 3 3 3 3 3 123 121 120 120 123 123 120 120 120 121 121 120 120 120 120 188 123 120 120 120 120 120 188 188 188 188 310 329 329 329 329 329 329 329 329 329 329 329 329 329 329 329 310 329 329 329 329 329 329 329 329 329 329 329 329 329 329 329 329 329 329 310 329 329 329 310 188 188 188 188 188 393 331 330 330 339 394 1 121 3 3 3 3 3 3 3 3 0 0 0 
3 3 3 3 3 3 3 3 3 3 120 121 121 121 120 123 121 121 121 121 120 120 121 121 120 188 120 120 123 123 123 120 120 120 120 120 120 120 120 188 188 188 188 188 188 188 188 188 188 188 188 188 309 188 188 188 188 188 188 188 188 188 188 188 188 188 188 188 188 188 188 188 188 188 188 188 188 188 188 188 188 393 331 330 330 339 394 1 121 3 3 3 3 3 3 3 3 0 0 0 
3 3 3 3 3 3 3 3 3 3 3 3 3 3 120 120 121 123 123 120 120 120 120 121 123 120 120 120 120 121 121 121 120 123 123 123 120 120 120 120 188 188 188 188 188 188 188 188 188 188 188 188 309 188 181 179 179 179 179 179 179 179 179 179 179 179 180 179 179 179 179 179 179 179 179 6 179 179 179 179 179 176 331 330 330 339 394 1 120 3 3 3 3 3 3 3 3 0 0 0 
3 3 3 3 3 3 3 3 3 3 3 3 3 3 120 120 120 120 120 3 3 3 120 120 120 121 121 123 120 120 123 123 120 120 123 121 121 123 123 120 120 120 120 188 188 188 188 188 188 188 188 188 309 188 183 265 265 265 265 265 265 265 265 265 265 265 183 336 332 332 332 332 332 332 332 112 332 332 332 332 332 332 333 330 341 335 394 1 123 3 3 3 3 3 3 3 3 3 0 0 
3 3 3 3 3 3 3 3 3 3 3 3 3 3 3 3 3 3 3 3 3 3 3 120 120 120 121 123 123 123 120 120 120 120 123 121 120 120 123 120 120 120 120 120 120 188 188 188 188 188 188 188 309 188 183 265 265 265 265 265 265 265 265 265 265 265 183 331 330 330 330 330 330 330 330 330 330 330 330 330 330 330 330 330 339 394 1 123 123 3 3 3 3 3 3 3 3 3 0 0 
0 3 3 3 3 3 3 3 3 3 3 3 3 3 3 3 3 3 3 3 3 3 3 3 120 120 120 121 123 123 123 123 121 120 120 120 123 123 123 123 120 120 120 120 120 120 120 188 188 188 188 188 309 188 183 265 265 265 265 265 265 265 265 265 265 265 183 331 330 330 330 330 330 330 330 330 330 330 330 330 330 341 338 338 335 394 121 121 3 3 3 3 3 3 3 3 3 3 0 0 
0 0 0 0 0 3 3 3 3 3 3 3 3 3 3 3 3 3 3 3 3 3 3 3 3 3 120 120 120 120 120 120 121 120 120 120 123 120 123 123 121 120 120 120 120 120 120 188 188 188 188 188 309 188 183 265 265 265 265 265 265 265 265 265 265 265 183 337 338 338 338 338 338 338 338 338 338 338 338 338 338 335 394 1 1 1 123 3 3 3 3 3 3 3 3 3 3 3 0 0 
0 0 0 0 0 0 3 3 3 3 3 3 3 3 3 3 3 3 3 3 3 3 3 3 3 3 3 3 3 3 3 120 123 123 123 123 123 121 123 120 121 121 123 123 123 123 123 123 183 188 188 188 309 188 183 265 265 265 265 265 265 265 265 265 265 265 185 179 179 179 179 179 179 179 179 179 179 179 179 179 179 178 1 1 1 120 121 3 3 3 3 3 3 3 3 3 3 0 0 0 
0 0 0 0 0 0 0 0 3 3 3 3 3 3 3 3 3 3 3 3 3 3 3 3 3 3 3 3 3 3 3 123 123 120 120 120 120 121 123 123 123 123 123 121 123 121 123 123 183 188 188 188 309 188 183 265 265 265 265 265 265 265 265 265 265 265 265 265 265 265 265 265 265 265 265 265 265 265 265 265 265 183 1 123 121 120 3 3 3 3 3 3 3 3 3 3 0 0 0 0 
0 0 0 0 0 0 0 0 0 0 3 3 3 3 3 3 3 3 3 3 3 3 3 3 3 3 3 3 3 3 3 123 123 121 121 123 120 120 120 121 121 123 120 121 120 120 123 123 183 188 188 188 309 188 183 265 265 265 265 265 265 265 265 265 265 265 265 265 265 265 265 265 265 265 265 265 265 265 265 265 265 183 120 121 3 3 3 3 3 3 3 3 3 3 3 3 0 0 0 0 
0 0 0 0 0 0 0 0 0 0 0 0 0 3 3 3 3 3 3 3 3 3 3 3 3 3 3 3 3 3 3 3 121 121 123 123 123 123 123 123 121 120 120 123 123 120 123 123 183 188 188 188 309 188 183 265 265 265 265 265 265 265 265 265 265 265 265 265 265 265 265 265 265 265 265 265 265 265 265 181 179 184 3 3 3 3 3 3 3 3 3 3 3 3 3 3 0 0 0 0 
0 0 0 0 0 0 0 0 0 0 0 0 0 0 0 3 3 3 3 3 3 3 3 3 3 3 3 3 3 3 3 3 3 3 3 3 3 3 123 123 123 120 121 123 123 120 121 123 183 188 188 188 309 188 183 265 265 265 265 265 265 265 265 265 265 265 265 265 265 265 265 265 265 265 265 265 265 181 179 184 171 171 3 3 3 3 3 3 3 3 3 3 3 3 3 3 0 0 0 0 
0 0 0 0 0 0 0 0 0 0 0 0 0 0 0 0 0 3 3 3 3 3 3 3 3 3 3 3 3 3 3 3 3 3 3 3 3 3 3 123 123 123 120 121 123 120 121 123 183 188 188 188 309 188 183 265 265 265 265 265 265 265 265 265 265 265 265 265 265 265 265 265 265 265 265 265 265 183 171 171 172 172 3 3 3 3 3 3 3 3 3 3 3 3 3 3 0 0 0 0 
0 0 0 0 0 0 0 0 0 0 0 0 0 0 0 0 0 0 0 3 3 3 3 3 3 3 3 3 3 3 3 3 3 3 3 3 3 3 3 3 123 120 120 120 120 123 121 123 183 188 188 188 309 188 183 265 265 265 265 265 265 265 265 265 265 265 265 265 265 265 265 265 265 265 265 265 265 183 172 172 144 144 3 3 3 3 3 3 3 3 3 3 3 3 3 0 0 0 0 0 
0 0 0 0 0 0 0 0 0 0 0 0 0 0 0 0 0 0 0 3 3 3 3 3 3 3 3 3 3 3 3 3 3 3 3 3 3 3 3 3 123 120 123 120 120 120 123 123 183 188 188 188 309 188 183 265 265 265 265 265 265 265 265 265 265 265 265 265 265 265 265 265 265 265 265 265 265 183 144 144 3 3 3 3 3 3 3 3 3 3 3 3 3 3 0 0 0 0 0 0 
0 0 0 0 0 0 0 0 0 0 0 0 0 0 0 0 0 0 0 0 0 3 3 3 3 3 3 3 3 3 3 3 3 3 3 3 3 3 3 3 123 123 123 121 121 120 120 123 183 188 188 188 309 188 183 265 265 265 265 265 265 265 265 265 265 265 265 265 265 265 265 265 265 265 265 265 265 183 147 3 3 3 3 3 3 3 3 3 3 3 3 3 3 0 0 0 0 0 0 0 
0 0 0 0 0 0 0 0 0 0 0 0 0 0 0 0 0 0 0 0 0 0 0 3 3 3 3 3 3 3 3 3 3 3 3 3 3 3 3 3 3 3 123 121 123 120 120 123 183 188 188 188 309 188 183 265 265 265 265 265 265 265 265 265 265 265 265 265 265 265 265 265 265 265 265 265 265 183 147 3 3 3 3 3 3 3 3 3 3 3 3 3 0 0 0 0 0 0 0 0 
0 0 0 0 0 0 0 0 0 0 0 0 0 0 0 0 0 0 0 0 0 0 0 0 0 3 3 3 3 3 3 3 3 3 3 3 3 3 3 3 3 3 121 121 123 175 179 179 184 188 188 188 309 188 185 179 179 179 179 179 179 179 179 179 179 179 179 179 179 179 179 179 179 179 179 179 179 184 147 3 3 3 3 3 3 3 3 3 3 3 3 3 0 0 0 0 0 0 0 0 
0 0 0 0 0 0 0 0 0 0 0 0 0 0 0 0 0 0 0 0 0 0 0 0 0 0 0 3 3 3 3 3 3 3 3 3 3 3 3 3 3 3 123 120 123 173 173 173 173 188 188 188 309 188 171 171 171 171 194 171 171 171 171 171 171 171 400 402 407 405 322 171 171 171 171 171 171 171 147 3 3 3 3 3 3 3 3 3 3 3 3 0 0 0 0 0 0 0 0 0 
0 0 0 0 0 0 0 0 0 0 0 0 0 0 0 0 0 0 0 0 0 0 0 0 0 0 0 0 3 3 3 3 3 3 3 3 3 3 3 3 3 3 3 123 121 174 174 174 174 188 188 188 309 188 172 172 172 172 172 194 172 172 172 172 172 172 322 403 404 406 322 172 172 172 172 172 172 172 147 3 3 3 3 3 3 3 3 3 3 3 0 0 0 0 0 0 0 0 0 0 
0 0 0 0 0 0 0 0 0 0 0 0 0 0 0 0 0 0 0 0 0 0 0 0 0 0 0 0 0 0 0 3 3 3 3 3 3 3 3 3 3 3 3 123 123 392 390 392 188 188 188 188 309 188 188 188 188 188 188 188 188 188 188 188 188 188 188 188 309 188 188 188 120 144 144 144 144 144 155 3 3 3 3 3 3 3 3 3 3 0 0 0 0 0 0 0 0 0 0 0 
0 0 0 0 0 0 0 0 0 0 0 0 0 0 0 0 0 0 0 0 0 0 0 0 0 0 0 0 0 0 0 0 3 3 3 3 3 3 3 3 3 3 3 3 123 188 188 188 188 188 188 188 310 329 329 329 329 329 329 329 329 329 329 329 329 329 329 329 310 188 188 121 123 3 3 3 3 3 3 3 3 3 3 3 3 3 3 3 0 0 0 0 0 0 0 0 0 0 0 0 
0 0 0 0 0 0 0 0 0 0 0 0 0 0 0 0 0 0 0 0 0 0 0 0 0 0 0 0 0 0 0 0 0 0 3 3 3 3 3 3 3 3 3 3 120 391 188 188 188 362 364 366 368 370 188 188 188 188 188 188 188 188 188 188 188 188 188 188 188 188 123 121 3 3 3 3 3 3 3 3 3 3 3 3 3 3 3 0 0 0 0 0 0 0 0 0 0 0 0 0 
0 0 0 0 0 0 0 0 0 0 0 0 0 0 0 0 0 0 0 0 0 0 0 0 0 0 0 0 0 0 0 0 0 0 3 3 3 3 3 3 3 3 3 3 123 123 121 188 188 363 365 367 369 371 188 188 188 188 188 188 188 188 188 188 188 188 188 188 188 188 188 120 123 3 3 3 3 3 3 3 3 3 3 3 3 3 3 0 0 0 0 0 0 0 0 0 0 0 0 0 
0 0 0 0 0 0 0 0 0 0 0 0 0 0 0 0 0 0 0 0 0 0 0 0 0 0 0 0 0 0 0 0 0 0 3 3 3 3 3 3 3 3 3 3 3 3 123 188 188 188 188 188 188 188 395 396 188 188 188 188 188 188 188 188 123 123 123 123 123 121 121 121 3 3 3 3 3 3 3 3 3 3 3 3 0 0 0 0 0 0 0 0 0 0 0 0 0 0 0 0 
0 0 0 0 0 0 0 0 0 0 0 0 0 0 0 0 0 0 0 0 0 0 0 0 0 0 0 0 0 0 0 0 0 0 3 3 3 3 3 123 121 123 121 123 123 121 123 123 120 120 120 123 143 143 397 398 123 188 188 188 123 123 120 123 120 120 120 120 120 121 120 123 123 3 3 3 3 3 3 3 3 3 3 0 0 0 0 0 0 0 0 0 0 0 0 0 0 0 0 0 
0 0 0 0 0 0 0 0 0 0 0 0 0 0 0 0 0 0 0 0 0 0 0 0 0 0 0 0 0 0 0 0 0 0 3 3 3 3 123 120 120 120 121 121 120 121 120 123 123 123 0 387 389 389 388 123 120 120 120 123 120 120 120 120 120 121 123 123 3 3 3 3 3 3 3 3 3 3 3 3 3 0 0 0 0 0 0 0 0 0 0 0 0 0 0 0 0 0 0 0 
0 0 0 0 0 0 0 0 0 0 0 0 0 0 0 0 0 0 0 0 0 0 0 0 0 0 0 0 0 0 0 0 3 3 3 3 3 123 120 123 123 121 123 121 120 123 120 123 0 0 0 383 381 381 382 123 123 120 120 123 123 123 120 123 123 3 3 3 3 3 3 3 3 3 3 3 3 3 3 0 0 0 0 0 0 0 0 0 0 0 0 0 0 0 0 0 0 0 0 0 
0 0 0 0 0 0 0 0 0 0 0 0 0 0 0 0 0 0 0 0 0 0 0 0 0 0 0 0 0 0 0 0 3 3 3 3 3 3 3 3 3 120 123 123 121 0 0 0 0 0 0 383 381 381 382 0 123 123 120 120 120 121 121 120 123 123 3 3 3 3 3 3 3 3 3 3 0 0 0 0 0 0 0 0 0 0 0 0 0 0 0 0 0 0 0 0 0 0 0 0 
0 0 0 0 0 0 0 0 0 0 0 0 0 0 0 0 0 0 0 0 0 0 0 0 0 0 0 0 0 0 0 0 3 3 3 3 3 3 3 3 3 3 120 120 120 0 0 0 0 0 383 381 381 381 382 0 0 123 121 123 123 123 121 123 123 3 3 3 3 3 3 3 3 3 3 3 0 0 0 0 0 0 0 0 0 0 0 0 0 0 0 0 0 0 0 0 0 0 0 0 
0 0 0 0 0 0 0 0 0 0 0 0 0 0 0 0 0 0 0 0 0 0 0 0 0 0 0 0 0 0 0 0 0 3 3 3 3 3 3 3 3 3 120 123 0 0 0 0 0 0 383 381 381 382 0 0 0 0 121 123 123 0 121 120 123 3 3 3 3 3 3 3 3 3 3 0 0 0 0 0 0 0 0 0 0 0 0 0 0 0 0 0 0 0 0 0 0 0 0 0 
0 0 0 0 0 0 0 0 0 0 0 0 0 0 0 0 0 0 0 0 0 0 0 0 0 0 0 0 0 0 0 0 0 3 3 3 3 3 3 3 3 3 3 120 0 0 0 0 0 383 381 381 382 0 0 0 0 0 0 0 0 0 123 121 120 3 3 3 3 3 3 3 3 3 3 0 0 0 0 0 0 0 0 0 0 0 0 0 0 0 0 0 0 0 0 0 0 0 0 0 
0 0 0 0 0 0 0 0 0 0 0 0 0 0 0 0 0 0 0 0 0 0 0 0 0 0 0 0 0 0 0 0 0 0 3 3 3 3 3 3 3 3 3 121 120 0 0 0 0 383 381 381 382 0 0 0 0 0 0 0 0 0 0 0 120 3 3 3 3 3 3 3 3 3 0 0 0 0 0 0 0 0 0 0 0 0 0 0 0 0 0 0 0 0 0 0 0 0 0 0 
0 0 0 0 0 0 0 0 0 0 0 0 0 0 0 0 0 0 0 0 0 0 0 0 0 0 0 0 0 0 0 0 0 0 3 3 3 3 3 3 3 3 3 120 123 0 0 0 0 383 381 381 382 0 0 0 0 0 0 0 0 0 0 123 123 3 3 3 3 3 3 3 3 0 0 0 0 0 0 0 0 0 0 0 0 0 0 0 0 0 0 0 0 0 0 0 0 0 0 0 
0 0 0 0 0 0 0 0 0 0 0 0 0 0 0 0 0 0 0 0 0 0 0 0 0 0 0 0 0 0 0 0 0 0 3 3 3 3 3 3 3 3 3 3 121 0 0 0 0 383 381 381 382 0 0 0 0 0 0 0 0 0 121 120 123 3 3 3 3 3 3 3 3 0 0 0 0 0 0 0 0 0 0 0 0 0 0 0 0 0 0 0 0 0 0 0 0 0 0 0 
0 0 0 0 0 0 0 0 0 0 0 0 0 0 0 0 0 0 0 0 0 0 0 0 0 0 0 0 0 0 0 0 0 0 3 3 3 3 3 3 3 3 3 3 121 0 0 0 383 381 381 381 382 0 0 0 0 0 0 0 0 123 120 120 3 3 3 3 3 3 3 3 3 0 0 0 0 0 0 0 0 0 0 0 0 0 0 0 0 0 0 0 0 0 0 0 0 0 0 0 
0 0 0 0 0 0 0 0 0 0 0 0 0 0 0 0 0 0 0 0 0 0 0 0 0 0 0 0 0 0 0 0 0 0 3 3 3 3 3 3 3 3 3 3 121 123 0 0 383 381 381 381 382 0 0 0 0 0 0 0 0 123 120 121 3 3 3 3 3 3 3 3 0 0 0 0 0 0 0 0 0 0 0 0 0 0 0 0 0 0 0 0 0 0 0 0 0 0 0 0 
0 0 0 0 0 0 0 0 0 0 0 0 0 0 0 0 0 0 0 0 0 0 0 0 0 0 0 0 0 0 0 0 0 3 3 3 3 3 3 3 3 3 123 120 121 121 0 0 383 381 381 381 382 0 0 0 0 0 0 0 123 123 121 121 3 3 3 3 3 3 3 3 0 0 0 0 0 0 0 0 0 0 0 0 0 0 0 0 0 0 0 0 0 0 0 0 0 0 0 0 
0 0 0 0 0 0 0 0 0 0 0 0 0 0 0 0 0 0 0 0 0 0 0 0 0 0 0 0 0 0 0 0 0 3 3 3 3 3 3 3 3 3 121 120 0 0 0 0 383 381 381 382 0 0 0 0 0 0 0 0 121 123 120 121 3 3 3 3 3 3 3 3 0 0 0 0 0 0 0 0 0 0 0 0 0 0 0 0 0 0 0 0 0 0 0 0 0 0 0 0 
0 0 0 0 0 0 0 0 0 0 0 0 0 0 0 0 0 0 0 0 0 0 0 0 0 0 0 0 0 0 0 0 3 3 3 3 3 3 3 3 120 123 121 123 0 0 0 0 383 381 381 382 0 0 0 0 0 0 0 0 121 123 120 3 3 3 3 3 3 3 3 3 0 0 0 0 0 0 0 0 0 0 0 0 0 0 0 0 0 0 0 0 0 0 0 0 0 0 0 0 
0 0 0 0 0 0 0 0 0 0 0 0 0 0 0 0 0 0 0 0 0 0 0 0 0 0 0 0 0 0 0 3 3 3 3 3 3 3 3 3 123 120 123 0 0 0 0 383 381 381 381 382 0 0 0 0 0 0 0 0 121 123 123 3 3 3 3 3 3 3 3 3 0 0 0 0 0 0 0 0 0 0 0 0 0 0 0 0 0 0 0 0 0 0 0 0 0 0 0 0 
0 0 0 0 0 0 0 0 0 0 0 0 0 0 0 0 0 0 0 0 0 0 0 0 0 0 0 0 0 0 0 3 3 3 3 3 3 3 3 3 3 120 0 0 0 0 0 383 381 381 381 382 0 0 0 0 0 0 0 123 123 121 3 3 3 3 3 3 3 3 3 3 0 0 0 0 0 0 0 0 0 0 0 0 0 0 0 0 0 0 0 0 0 0 0 0 0 0 0 0 
0 0 0 0 0 0 0 0 0 0 0 0 0 0 0 0 0 0 0 0 0 0 0 0 0 0 0 0 0 0 0 0 3 3 3 3 3 3 3 3 3 121 123 0 0 0 0 383 381 381 382 0 0 0 0 0 0 0 123 121 120 121 3 3 3 3 3 3 3 3 3 0 0 0 0 0 0 0 0 0 0 0 0 0 0 0 0 0 0 0 0 0 0 0 0 0 0 0 0 0 
0 0 0 0 0 0 0 0 0 0 0 0 0 0 0 0 0 0 0 0 0 0 0 0 0 0 0 0 0 0 0 0 3 3 3 3 3 3 3 3 3 123 0 0 0 0 0 383 381 381 382 0 0 0 0 0 0 0 121 120 123 3 3 3 3 3 3 3 3 3 3 0 0 0 0 0 0 0 0 0 0 0 0 0 0 0 0 0 0 0 0 0 0 0 0 0 0 0 0 0 
0 0 0 0 0 0 0 0 0 0 0 0 0 0 0 0 0 0 0 0 0 0 0 0 0 0 0 0 0 0 0 0 3 3 3 3 3 3 3 3 123 120 0 0 0 0 383 381 381 381 382 0 0 0 0 0 0 0 121 120 123 3 3 3 3 3 3 3 3 3 3 0 0 0 0 0 0 0 0 0 0 0 0 0 0 0 0 0 0 0 0 0 0 0 0 0 0 0 0 0 
0 0 0 0 0 0 0 0 0 0 0 0 0 0 0 0 0 0 0 0 0 0 0 0 0 0 0 0 0 0 0 0 3 3 3 3 3 3 3 3 120 120 0 0 0 0 383 381 381 382 0 0 0 0 0 0 0 0 123 120 123 3 3 3 3 3 3 3 3 3 3 0 0 0 0 0 0 0 0 0 0 0 0 0 0 0 0 0 0 0 0 0 0 0 0 0 0 0 0 0 
0 0 0 0 0 0 0 0 0 0 0 0 0 0 0 0 0 0 0 0 0 0 0 0 0 0 0 0 0 0 0 0 3 3 3 3 3 3 3 121 121 121 0 0 0 0 383 381 381 382 0 0 0 0 0 0 0 0 120 120 123 3 3 3 3 3 3 3 3 3 3 0 0 0 0 0 0 0 0 0 0 0 0 0 0 0 0 0 0 0 0 0 0 0 0 0 0 0 0 0 
0 0 0 0 0 0 0 0 0 0 0 0 0 0 0 0 0 0 0 0 0 0 0 0 0 0 0 0 0 0 0 3 3 3 3 3 3 3 3 120 120 120 0 0 0 0 383 381 381 382 0 0 0 0 0 0 123 123 120 3 3 3 3 3 3 3 3 3 3 3 3 0 0 0 0 0 0 0 0 0 0 0 0 0 0 0 0 0 0 0 0 0 0 0 0 0 0 0 0 0 
0 0 0 0 0 0 0 0 0 0 0 0 0 0 0 0 0 0 0 0 0 0 0 0 0 0 0 0 0 0 0 3 3 3 3 3 3 3 3 3 123 120 0 0 0 0 383 381 381 381 382 0 0 0 0 0 120 123 3 3 3 3 3 3 3 3 3 3 3 3 0 0 0 0 0 0 0 0 0 0 0 0 0 0 0 0 0 0 0 0 0 0 0 0 0 0 0 0 0 0 
0 0 0 0 0 0 0 0 0 0 0 0 0 0 0 0 0 0 0 0 0 0 0 0 0 0 0 0 0 0 0 3 3 3 3 3 3 3 3 3 3 121 0 0 0 0 383 381 381 381 382 0 0 0 0 0 123 123 121 123 3 3 3 3 3 3 3 3 3 3 0 0 0 0 0 0 0 0 0 0 0 0 0 0 0 0 0 0 0 0 0 0 0 0 0 0 0 0 0 0 
0 0 0 0 0 0 0 0 0 0 0 0 0 0 0 0 0 0 0 0 0 0 0 0 0 0 0 0 0 0 0 3 3 3 3 3 3 3 3 3 148 120 0 0 0 0 386 385 385 385 384 0 0 0 0 123 121 123 120 3 3 3 3 3 3 3 3 3 3 3 3 0 0 0 0 0 0 0 0 0 0 0 0 0 0 0 0 0 0 0 0 0 0 0 0 0 0 0 0 0 
0 0 0 0 0 0 0 0 0 0 0 0 0 0 0 0 0 0 0 0 0 0 0 0 0 0 0 0 0 0 0 0 3 3 3 3 3 3 3 3 148 123 121 0 0 104 103 103 103 103 103 103 103 103 103 105 121 123 120 3 3 3 3 3 3 3 3 3 3 3 3 0 0 0 0 0 0 0 0 0 0 0 0 0 0 0 0 0 0 0 0 0 0 0 0 0 0 0 0 0 
0 0 0 0 0 0 0 0 0 0 0 0 0 0 0 0 0 0 0 0 0 0 0 0 0 0 0 0 0 0 0 3 3 3 3 3 3 3 3 3 3 148 121 120 0 102 2 2 2 2 2 2 2 2 2 101 0 0 3 3 3 3 3 3 3 3 3 3 3 3 3 3 0 0 0 0 0 0 0 0 0 0 0 0 0 0 0 0 0 0 0 0 0 0 0 0 0 0 0 0 
0 0 0 0 0 0 0 0 0 0 0 0 0 0 0 0 0 0 0 0 0 0 0 0 0 0 0 0 0 0 0 3 3 3 3 3 3 3 3 3 3 3 148 123 123 102 2 2 2 2 2 2 2 2 2 2 2 2 161 3 3 3 3 3 3 3 3 3 3 3 3 3 3 0 0 0 0 0 0 0 0 0 0 0 0 0 0 0 0 0 0 0 0 0 0 0 0 0 0 0 
0 0 0 0 0 0 0 0 0 0 0 0 0 0 0 0 0 0 0 0 0 0 0 0 0 0 0 0 0 0 3 3 3 3 3 3 3 3 3 3 3 3 148 120 120 121 2 2 2 2 2 2 2 2 2 2 2 2 161 3 3 3 3 3 3 3 3 3 3 3 3 3 3 0 0 0 0 0 0 0 0 0 0 0 0 0 0 0 0 0 0 0 0 0 0 0 0 0 0 0 
0 0 0 0 0 0 0 0 0 0 0 0 0 0 0 0 0 0 0 0 0 0 0 0 0 0 0 0 0 0 3 3 3 3 3 3 3 3 3 3 3 3 148 121 120 102 2 2 2 2 2 2 2 2 2 2 2 2 164 163 167 3 3 3 3 3 3 3 3 3 3 3 0 0 0 0 0 0 0 0 0 0 0 0 0 0 0 0 0 0 0 0 0 0 0 0 0 0 0 0 
0 0 0 0 0 0 0 0 0 0 0 0 0 0 0 0 0 0 0 0 0 0 0 0 0 0 0 0 0 0 0 3 3 3 3 3 3 3 3 3 3 3 148 120 123 102 2 2 2 2 2 2 2 2 2 2 2 2 2 2 161 3 3 3 3 3 3 3 3 3 3 3 0 0 0 0 0 0 0 0 0 0 0 0 0 0 0 0 0 0 0 0 0 0 0 0 0 0 0 0 
0 0 0 0 0 0 0 0 0 0 0 0 0 0 0 0 0 0 0 0 0 0 0 0 0 0 0 0 0 0 0 3 3 3 3 3 3 3 3 3 3 3 3 148 123 102 2 2 2 2 2 2 2 2 2 2 2 2 2 2 161 3 3 3 3 3 3 3 3 3 3 3 0 0 0 0 0 0 0 0 0 0 0 0 0 0 0 0 0 0 0 0 0 0 0 0 0 0 0 0 
0 0 0 0 0 0 0 0 0 0 0 0 0 0 0 0 0 0 0 0 0 0 0 0 0 0 0 0 0 0 0 0 3 3 3 3 3 3 3 3 3 3 3 148 121 123 2 2 2 2 2 2 2 2 2 2 2 2 2 159 169 3 3 3 3 3 3 3 3 3 3 3 0 0 0 0 0 0 0 0 0 0 0 0 0 0 0 0 0 0 0 0 0 0 0 0 0 0 0 0 
0 0 0 0 0 0 0 0 0 0 0 0 0 0 0 0 0 0 0 0 0 0 0 0 0 0 0 0 0 0 0 0 0 3 3 3 3 3 3 3 3 3 3 148 121 123 2 2 2 2 2 2 2 2 2 2 2 2 2 161 3 3 3 3 3 3 3 3 3 3 3 3 0 0 0 0 0 0 0 0 0 0 0 0 0 0 0 0 0 0 0 0 0 0 0 0 0 0 0 0 
0 0 0 0 0 0 0 0 0 0 0 0 0 0 0 0 0 0 0 0 0 0 0 0 0 0 0 0 0 0 0 0 0 3 3 3 3 3 3 3 3 3 3 148 123 2 2 2 2 2 2 2 2 2 2 2 2 2 2 161 3 3 3 3 3 3 3 3 3 3 3 0 0 0 0 0 0 0 0 0 0 0 0 0 0 0 0 0 0 0 0 0 0 0 0 0 0 0 0 0 
0 0 0 0 0 0 0 0 0 0 0 0 0 0 0 0 0 0 0 0 0 0 0 0 0 0 0 0 0 0 0 0 0 0 3 3 3 3 3 3 3 3 3 154 144 158 158 158 158 158 158 158 158 158 158 158 158 158 158 169 3 3 3 3 3 3 3 3 3 3 0 0 0 0 0 0 0 0 0 0 0 0 0 0 0 0 0 0 0 0 0 0 0 0 0 0 0 0 0 0 
3 3 3 3 3 3 3 3 3 3 3 3 3 3 3 3 3 3 3 3 3 3 3 3 3 3 3 3 3 3 3 3 3 3 3 3 3 3 3 3 3 3 3 3 3 3 3 3 3 3 3 3 3 3 3 3 3 3 3 3 3 3 3 3 3 3 3 3 3 3 3 3 3 3 3 3 3 3 3 3 3 3 3 3 3 3 3 3 3 3 3 3 3 3 3 3 3 3 3 3 
3 3 3 3 3 3 3 3 3 3 3 3 3 3 3 3 3 3 3 3 3 3 3 3 3 3 3 3 3 3 3 3 3 3 3 3 3 3 3 3 3 3 3 3 3 3 3 3 3 3 3 3 3 3 3 3 3 3 3 3 3 3 3 3 3 3 3 3 3 3 3 3 3 3 3 3 3 3 3 3 3 3 3 3 3 3 3 3 3 3 3 3 3 3 3 3 3 3 3 3 
3 3 3 3 3 3 3 3 3 3 3 3 3 3 3 3 3 3 3 3 3 3 3 3 3 3 3 3 3 3 3 3 3 3 3 3 3 3 3 3 3 3 3 3 3 3 3 3 3 3 3 3 3 3 3 3 3 3 3 3 3 3 3 3 3 3 3 3 3 3 3 3 3 3 3 3 3 3 3 3 3 3 3 3 3 3 3 3 3 3 3 3 3 3 3 3 3 3 3 3 
3 3 3 3 3 3 3 3 3 3 3 3 3 3 3 3 3 3 3 3 3 3 3 3 3 3 3 3 3 3 3 3 3 3 3 3 3 3 3 3 3 3 3 3 3 3 3 3 3 3 3 3 3 3 3 3 3 3 3 3 3 3 3 3 3 3 3 3 3 3 3 3 3 3 3 3 3 3 3 3 3 3 3 3 3 3 3 3 3 3 3 3 3 3 3 3 3 3 3 3 
3 3 3 3 3 3 3 3 3 3 3 3 3 3 3 3 3 3 3 3 3 3 3 3 3 3 3 3 3 3 3 3 3 3 3 3 3 3 3 3 3 3 3 3 3 3 3 3 3 3 3 3 3 3 3 3 3 3 3 3 3 3 3 3 3 3 3 3 3 3 3 3 3 3 3 3 3 3 3 3 3 3 3 3 3 3 3 3 3 3 3 3 3 3 3 3 3 3 3 3 
3 3 3 3 3 3 3 3 3 3 3 3 3 3 3 3 3 3 3 3 3 3 3 3 3 3 3 3 3 3 3 3 3 3 3 3 3 3 3 3 3 3 3 3 3 3 3 3 3 3 3 3 3 3 3 3 3 3 3 3 3 3 3 3 3 3 3 3 3 3 3 3 3 3 3 3 3 3 3 3 3 3 3 3 3 3 3 3 3 3 3 3 3 3 3 3 3 3 3 3 