0 0 0 0 0 0 0 0 0 0 0 0 0 0 0 0 0 3 3 3 3 3 3 3 3 3 3 3 3 3 3 3 3 3 3 3 3 3 3 3 3 3 3 3 3 3 3 3 3 3 3 3 3 3 3 3 3 3 3 3 3 3 3 3 3 3 3 3 3 3 3 3 3 3 3 3 3 3 3 3 3 3 3 3 0 0 0 0 0 0 0 0 0 0 0 0 0 0 0 0 
0 0 0 0 0 0 0 0 0 0 0 0 3 3 3 3 3 3 3 3 3 3 3 3 3 3 3 3 3 3 3 3 3 3 3 3 3 3 3 3 3 3 3 3 3 3 3 3 3 3 3 3 3 3 3 3 3 3 3 3 3 3 3 3 3 3 3 3 3 3 3 3 3 3 3 3 3 3 3 3 3 3 3 3 0 0 0 0 0 0 0 0 0 0 0 0 0 0 0 0 
0 3 3 3 3 3 3 3 3 3 3 3 3 3 3 3 3 3 3 3 3 3 3 3 3 3 3 3 3 3 3 3 3 3 3 3 3 3 3 3 3 3 3 3 3 3 3 3 3 3 3 3 3 3 3 3 3 3 3 3 3 3 3 3 3 3 3 3 3 3 3 3 3 3 3 3 3 3 3 3 3 3 3 3 3 3 3 3 0 0 0 0 0 0 0 0 0 0 0 0 
3 3 3 3 3 3 3 3 3 3 3 3 3 3 3 3 3 3 3 3 3 3 3 3 3 3 3 3 207 206 206 206 206 206 206 206 206 206 206 206 205 3 3 3 3 3 3 3 3 3 3 3 3 3 3 3 3 3 3 3 3 3 3 3 3 3 3 3 3 3 3 3 3 3 3 3 3 3 3 3 3 3 3 3 3 3 3 3 3 3 3 3 3 3 0 0 0 0 0 0 
3 3 3 3 3 3 3 3 3 3 3 3 3 3 3 3 3 3 3 3 3 3 3 3 3 3 3 3 201 265 265 265 265 265 265 265 265 265 265 265 201 3 3 3 3 3 3 3 3 3 3 3 3 3 3 3 3 3 3 3 3 3 3 3 3 3 3 3 3 3 3 3 3 3 3 3 3 3 3 3 3 3 3 3 3 3 3 3 0 0 0 3 0 0 0 0 0 0 0 0 
3 3 3 3 3 3 3 3 3 3 3 3 3 3 3 3 3 3 3 3 3 3 3 3 3 3 3 3 201 265 265 265 265 265 265 265 265 265 265 265 201 3 3 3 3 3 3 3 3 3 3 3 3 3 3 3 3 3 3 3 3 3 3 3 3 3 3 3 3 3 3 3 3 3 3 3 3 3 3 3 3 3 3 3 3 3 3 3 0 0 3 0 0 0 0 0 0 0 0 0 
3 3 3 3 3 3 3 3 3 3 3 3 3 3 3 3 3 3 3 3 3 3 3 3 3 3 3 3 201 265 265 265 265 265 265 265 265 265 265 265 201 3 3 3 3 3 3 3 3 3 3 3 3 3 181 206 206 206 206 206 206 206 205 3 3 3 3 3 3 3 3 3 3 3 3 3 3 3 3 3 3 3 3 3 3 3 3 3 0 3 3 0 0 3 3 3 0 0 0 0 
3 3 3 3 3 3 3 3 3 3 3 3 3 3 3 3 3 3 3 3 3 3 3 3 3 3 3 3 201 265 265 265 265 265 265 265 265 265 265 265 201 3 3 3 3 3 3 3 3 3 3 3 3 3 183 265 265 265 265 265 265 265 201 3 3 3 3 3 3 3 3 3 3 3 3 3 3 3 3 3 3 3 3 3 3 3 3 3 3 3 3 3 3 3 3 3 0 0 0 0 
3 3 3 3 3 3 3 3 3 3 3 3 3 3 3 3 3 3 3 3 3 3 3 3 3 3 3 3 201 265 265 265 265 265 265 265 265 265 265 265 201 3 3 3 3 3 3 3 3 3 3 3 3 3 183 265 265 265 265 265 265 265 201 3 3 3 3 3 3 3 3 3 3 3 3 3 3 3 3 3 3 3 3 3 3 3 3 3 3 3 3 3 3 3 3 0 0 0 0 0 
3 3 3 3 3 3 3 3 3 3 3 3 181 179 179 179 179 179 179 179 179 179 179 179 179 179 179 179 184 265 265 265 265 265 265 265 265 265 265 265 201 3 3 3 3 3 3 3 3 3 3 3 3 3 183 265 265 265 265 265 265 265 201 3 3 3 3 3 3 3 3 3 3 3 3 3 3 3 3 3 3 3 3 3 3 3 3 3 3 3 3 3 3 3 3 0 0 0 0 0 
3 3 3 3 3 3 3 3 3 3 3 3 183 265 265 265 265 265 265 265 265 265 265 265 265 265 265 265 265 265 265 265 265 265 265 265 265 265 265 265 201 3 3 3 3 3 3 3 3 3 3 3 3 3 183 265 265 265 265 265 265 265 201 3 3 3 3 3 3 3 3 3 3 3 3 3 3 3 3 3 3 3 3 3 3 3 3 3 3 3 3 3 3 0 0 0 0 0 0 0 
3 3 3 3 3 3 3 3 3 3 3 3 183 265 265 265 265 265 265 265 265 265 265 265 265 265 265 265 265 265 265 265 265 265 265 265 265 265 265 265 201 3 3 3 3 3 3 3 3 3 3 3 3 3 201 265 265 265 265 265 265 265 201 3 3 3 3 3 3 3 207 206 206 206 206 206 206 206 206 206 5 5 3 3 3 3 3 3 3 3 3 3 3 0 0 0 0 0 0 0 
3 3 3 3 3 3 3 3 3 3 3 3 183 265 265 265 265 265 265 265 265 265 265 265 265 265 265 265 265 265 265 265 265 265 265 265 265 265 265 265 201 3 3 3 3 3 3 3 3 3 3 3 3 3 201 265 265 265 265 265 265 265 201 3 3 3 3 3 3 3 201 265 265 265 265 265 265 265 265 265 265 5 5 3 3 3 3 3 3 3 3 3 3 0 0 0 0 0 0 0 
3 3 3 3 3 3 3 3 3 3 3 3 183 265 265 265 265 265 265 265 265 265 265 265 265 265 265 265 265 265 265 265 265 265 265 265 265 265 265 265 201 3 3 3 3 3 3 3 3 3 3 3 3 3 201 265 265 265 265 265 265 265 201 3 3 3 3 3 3 3 201 265 265 265 265 265 265 265 265 265 265 265 5 5 5 3 3 3 3 3 3 3 3 3 0 0 0 0 0 0 
3 3 3 3 3 3 3 3 3 3 3 3 183 265 265 265 265 265 265 265 265 265 265 265 265 265 265 265 265 265 265 265 265 265 265 265 265 265 265 265 200 206 206 206 206 206 206 206 206 206 206 206 206 206 210 265 265 265 265 265 265 265 200 206 206 206 206 206 206 206 210 265 265 265 265 265 265 265 265 265 265 265 265 5 5 3 3 3 3 3 3 3 3 3 0 0 0 0 0 0 
3 3 3 3 3 3 3 3 3 3 3 3 183 265 265 265 265 265 265 265 265 265 265 265 265 265 265 265 265 265 265 265 265 265 265 265 265 265 265 265 265 265 265 265 265 265 265 265 265 265 265 265 265 265 265 265 265 265 265 265 265 265 265 265 265 265 265 265 265 265 265 265 265 265 265 265 265 265 265 265 265 265 265 5 5 5 5 3 3 3 3 3 3 0 0 0 0 0 0 0 
3 3 3 3 3 3 3 3 3 3 3 3 183 265 265 265 265 265 265 265 265 265 265 265 265 265 265 265 265 265 265 265 265 265 265 265 265 265 265 265 265 265 265 265 265 265 265 265 265 265 265 265 265 265 265 265 265 265 265 265 265 265 265 265 265 265 265 265 265 265 265 265 265 265 265 265 265 265 265 265 265 265 265 265 5 5 5 3 3 3 3 3 3 3 3 3 0 0 0 0 
3 3 3 3 3 3 3 3 3 3 3 3 183 265 265 265 265 265 265 265 265 265 265 265 265 265 265 265 265 265 265 265 265 265 265 265 265 265 265 265 265 265 265 265 265 265 265 265 265 265 265 265 265 265 265 265 265 265 265 265 265 265 265 265 265 265 265 265 265 265 265 265 265 265 265 265 265 265 265 265 265 265 265 265 5 5 5 3 3 3 3 3 3 3 3 3 3 0 0 0 
3 3 3 3 3 3 3 3 3 3 5 5 183 265 265 265 265 181 179 179 179 179 179 179 179 179 179 179 178 265 265 265 265 265 265 265 265 265 265 181 179 179 179 179 179 179 179 179 179 179 179 179 179 179 179 179 179 179 179 179 179 179 179 179 179 179 179 179 179 179 179 179 179 179 179 179 179 179 179 179 179 179 179 179 176 5 5 3 3 3 3 3 3 3 3 3 3 0 0 0 
3 3 3 3 3 3 3 3 3 5 5 5 185 179 179 179 179 184 171 194 171 194 171 171 171 192 192 171 183 265 265 265 265 265 265 265 265 265 265 183 265 265 265 265 265 265 265 265 265 265 265 265 265 265 265 265 265 265 265 265 265 265 265 265 265 265 265 265 265 265 265 265 265 265 336 332 332 332 332 332 332 332 332 332 334 5 5 5 3 3 3 3 3 3 3 3 3 0 0 0 
3 3 3 3 3 3 3 3 5 5 5 5 193 171 171 194 171 171 172 172 194 172 172 192 172 172 172 172 183 265 265 265 265 265 265 265 265 265 265 183 265 265 265 265 265 265 265 265 265 265 265 265 265 265 265 265 265 265 265 265 265 265 265 265 265 265 265 265 265 265 265 265 265 265 337 340 330 330 330 330 330 330 330 330 339 394 1 5 5 3 3 3 3 3 3 3 3 0 0 0 
3 3 3 3 3 3 3 3 5 5 5 5 172 191 191 172 194 194 188 188 188 188 188 188 188 188 188 188 185 179 179 179 179 179 179 179 179 179 179 177 179 179 179 179 179 179 179 179 178 265 265 265 265 265 265 265 265 265 265 265 265 265 265 265 265 265 265 265 265 265 265 265 265 265 265 337 338 338 338 338 338 338 330 330 339 394 1 1 5 3 3 3 3 3 3 3 3 0 0 0 
3 3 3 3 3 3 3 3 5 5 5 5 188 188 188 188 188 188 188 188 188 188 188 188 188 188 188 188 171 192 192 171 171 171 171 323 324 171 192 171 171 171 171 171 194 171 171 171 183 265 265 265 265 265 265 265 265 265 265 265 265 265 265 265 265 265 265 265 265 265 265 265 265 265 265 265 265 265 265 265 265 265 331 330 342 334 394 1 5 5 3 3 3 3 3 3 3 0 0 0 
3 3 3 3 3 3 3 3 5 5 5 5 188 188 188 188 188 188 188 188 188 188 188 188 188 188 188 188 172 172 172 172 172 194 191 325 326 193 191 172 172 194 172 172 172 172 191 172 185 179 179 179 179 179 179 179 179 179 179 179 179 179 179 179 179 179 179 179 179 179 179 179 179 179 179 179 179 179 179 179 179 179 331 330 330 339 394 1 1 5 3 3 3 3 3 3 3 3 0 0 
3 3 3 3 3 3 3 3 5 5 5 5 188 188 188 188 188 188 188 188 188 188 188 188 188 188 188 188 188 188 316 315 315 315 317 188 188 310 188 188 188 188 188 188 188 188 188 188 171 192 192 171 171 192 171 171 171 171 194 194 171 171 171 171 171 192 171 171 171 192 171 171 171 171 171 171 191 193 171 171 171 171 331 330 330 339 394 1 1 5 5 3 3 3 3 3 3 3 0 0 
3 3 3 3 3 3 3 3 5 5 5 0 188 188 188 188 188 188 188 188 188 188 188 188 188 188 188 188 188 188 314 320 311 320 313 188 188 309 188 188 188 188 188 188 188 188 188 188 172 172 172 172 191 172 191 172 172 172 172 172 191 193 172 172 172 172 194 172 192 172 194 172 172 194 194 172 172 172 192 172 192 172 331 330 330 339 394 1 1 1 5 3 3 3 3 3 3 3 0 0 
3 3 3 3 3 3 3 5 5 5 5 5 188 188 188 188 188 188 188 188 188 188 188 188 188 188 188 188 188 188 314 311 320 311 313 188 188 309 316 315 315 315 315 317 188 188 188 188 188 188 188 188 188 188 188 188 188 188 188 188 188 188 188 188 188 188 188 188 188 188 188 188 188 188 188 188 188 188 188 188 188 393 331 330 330 339 394 1 1 1 5 3 3 3 3 3 3 3 0 0 
3 3 3 3 3 3 3 3 5 5 5 5 188 188 188 188 188 188 188 188 188 188 188 188 188 188 188 188 188 188 188 312 312 312 319 188 188 309 314 311 320 311 320 313 188 188 316 315 315 315 315 315 317 188 316 315 315 315 315 315 315 315 315 317 316 315 315 315 315 317 188 188 188 393 393 393 393 393 393 393 393 393 331 330 330 339 394 1 1 1 5 3 3 3 3 3 3 3 0 0 
3 3 3 3 3 3 3 3 5 5 5 5 188 188 188 188 188 188 188 188 188 188 188 188 188 188 188 188 188 188 316 315 315 315 317 188 188 309 314 320 311 320 311 313 188 188 314 320 311 311 320 311 313 188 314 320 311 320 311 320 311 320 311 313 314 311 320 320 311 313 188 188 188 375 372 372 372 372 372 372 372 378 330 330 330 339 394 1 1 5 5 3 3 3 3 3 3 3 0 0 
3 3 3 3 3 3 3 3 5 5 5 5 188 188 188 188 188 188 188 188 188 188 188 188 188 188 188 188 188 188 314 311 320 311 313 188 188 309 314 311 320 311 320 313 188 188 314 311 320 311 311 311 313 188 314 311 320 311 320 311 320 311 320 313 314 320 311 311 320 313 188 310 188 376 373 373 373 373 373 373 373 379 330 330 330 339 394 1 1 5 3 3 3 3 3 3 3 3 0 0 
3 3 3 3 3 3 3 3 5 5 5 5 188 188 188 188 188 188 188 188 188 188 188 188 188 188 188 188 188 188 314 320 311 320 313 188 188 309 318 312 312 312 312 319 188 188 318 312 312 311 320 311 313 188 314 320 311 320 311 320 311 320 311 313 314 311 320 320 311 313 188 309 188 377 374 374 374 380 380 374 380 380 330 330 330 339 394 1 1 5 3 3 3 3 3 3 3 0 0 0 
3 3 3 3 3 3 3 3 3 5 5 5 188 188 188 188 188 188 188 188 188 188 188 188 188 188 188 188 188 188 318 312 312 312 319 188 188 309 188 188 188 188 188 188 188 188 188 188 188 312 312 312 319 188 318 312 312 312 312 312 312 312 312 319 318 312 312 312 312 319 188 309 188 393 393 393 393 393 393 393 393 393 331 330 330 339 394 1 5 5 3 3 3 3 3 3 3 0 0 0 
3 3 3 3 3 3 3 3 3 3 5 5 5 5 5 5 5 5 5 5 5 5 5 5 5 188 5 5 5 5 5 5 188 188 188 188 188 310 329 329 329 329 329 329 329 329 329 329 329 329 329 329 310 329 329 329 329 329 329 329 329 329 329 329 329 329 329 329 329 329 329 310 329 329 329 310 188 188 188 188 188 393 331 330 330 339 394 1 5 3 3 3 3 3 3 3 3 0 0 0 
3 3 3 3 3 3 3 3 3 3 5 5 5 5 5 5 0 5 5 5 5 5 5 0 5 188 5 5 5 5 0 5 5 5 5 5 5 5 5 188 188 188 188 188 188 188 188 188 188 188 188 188 309 188 188 188 188 188 188 188 188 188 188 188 188 188 188 188 188 188 188 188 188 188 188 188 188 188 188 188 188 393 331 330 330 339 394 1 5 3 3 3 3 3 3 3 3 0 0 0 
3 3 3 3 3 3 3 3 3 3 3 3 3 3 5 5 5 5 5 5 5 5 5 5 5 5 5 0 0 5 5 5 0 5 5 0 0 0 5 5 188 188 188 188 188 188 188 188 188 188 188 188 309 188 181 179 179 179 179 179 179 179 179 179 179 179 180 179 179 179 179 179 179 179 179 6 179 179 179 179 179 176 331 330 330 339 394 1 5 3 3 3 3 3 3 3 3 0 0 0 
3 3 3 3 3 3 3 3 3 3 3 3 3 3 5 5 5 5 5 3 3 3 5 5 5 5 5 5 0 0 0 0 0 0 0 0 0 0 5 5 5 5 5 188 188 188 188 188 188 188 188 188 309 188 183 265 265 265 265 265 265 265 265 265 265 265 183 336 332 332 332 332 332 332 332 332 332 332 332 332 332 332 333 330 341 335 394 1 5 3 3 3 3 3 3 3 3 3 0 0 
3 3 3 3 3 3 3 3 3 3 3 3 3 3 3 3 3 3 3 3 3 3 3 5 5 0 0 5 5 5 5 5 0 0 0 0 0 0 5 5 0 0 5 5 5 188 188 188 188 188 188 188 309 188 183 265 265 265 265 265 265 265 265 265 265 265 183 331 330 330 330 330 330 330 330 330 330 330 330 330 330 330 330 330 339 394 1 5 5 3 3 3 3 3 3 3 3 3 0 0 
0 3 3 3 3 3 3 3 3 3 3 3 3 3 3 3 3 3 3 3 3 3 3 3 5 5 0 0 0 5 5 5 5 5 5 5 5 5 5 0 0 0 0 0 5 5 5 188 188 188 188 188 309 188 183 265 265 265 265 265 265 265 265 265 265 265 183 331 330 330 330 330 330 330 330 330 330 330 330 330 330 341 338 338 335 394 5 5 3 3 3 3 3 3 3 3 3 3 0 0 
0 0 0 0 0 3 3 3 3 3 3 3 3 3 3 3 3 3 3 3 3 3 3 3 3 3 5 5 5 5 5 5 5 5 5 5 5 5 5 5 5 5 5 5 5 5 5 188 188 188 188 188 309 188 183 265 265 265 265 265 265 265 265 265 265 265 183 337 338 338 338 338 338 338 338 338 338 338 338 338 338 335 394 1 1 1 5 3 3 3 3 3 3 3 3 3 3 3 0 0 
0 0 0 0 0 0 3 3 3 3 3 3 3 3 3 3 3 3 3 3 3 3 3 3 3 3 3 3 3 3 3 5 5 5 5 5 5 5 5 5 5 5 5 5 5 5 5 5 183 188 188 188 309 188 183 265 265 265 265 265 265 265 265 265 265 265 185 179 179 179 179 179 179 179 179 179 179 179 179 179 179 178 1 1 1 5 5 3 3 3 3 3 3 3 3 3 3 0 0 0 
0 0 0 0 0 0 0 0 3 3 3 3 3 3 3 3 3 3 3 3 3 3 3 3 3 3 3 3 3 3 3 5 0 5 5 5 5 0 0 0 5 5 5 5 5 5 5 5 183 188 188 188 309 188 183 265 265 265 265 265 265 265 265 265 265 265 265 265 265 265 265 265 265 265 265 265 265 265 265 265 265 183 1 5 5 5 3 3 3 3 3 3 3 3 3 3 0 0 0 0 
0 0 0 0 0 0 0 0 0 0 3 3 3 3 3 3 3 3 3 3 3 3 3 3 3 3 3 3 3 3 3 5 5 0 0 0 5 5 5 0 0 5 5 5 5 5 5 5 183 188 188 188 309 188 183 265 265 265 265 265 265 265 265 265 265 265 265 265 265 265 265 265 265 265 265 265 265 265 265 265 265 183 5 5 3 3 3 3 3 3 3 3 3 3 3 3 0 0 0 0 
0 0 0 0 0 0 0 0 0 0 0 0 0 3 3 3 3 3 3 3 3 3 3 3 3 3 3 3 3 3 3 3 5 5 5 5 5 5 5 5 0 0 0 5 5 0 0 0 183 188 188 188 309 188 183 265 265 265 265 265 265 265 265 265 265 265 265 265 265 265 265 265 265 265 265 265 265 265 265 181 179 184 3 3 3 3 3 3 3 3 3 3 3 3 3 3 0 0 0 0 
0 0 0 0 0 0 0 0 0 0 0 0 0 0 0 3 3 3 3 3 3 3 3 3 3 3 3 3 3 3 3 3 3 3 3 3 3 3 5 5 5 0 0 0 0 0 0 0 183 188 188 188 309 188 183 265 265 265 265 265 265 265 265 265 265 265 265 265 265 265 265 265 265 265 265 265 265 181 179 184 171 171 3 3 3 3 3 3 3 3 3 3 3 3 3 3 0 0 0 0 
0 0 0 0 0 0 0 0 0 0 0 0 0 0 0 0 0 3 3 3 3 3 3 3 3 3 3 3 3 3 3 3 3 3 3 3 3 3 3 5 5 5 0 0 0 0 0 0 183 188 188 188 309 188 183 265 265 265 265 265 265 265 265 265 265 265 265 265 265 265 265 265 265 265 265 265 265 183 171 171 172 172 3 3 3 3 3 3 3 3 3 3 3 3 3 3 0 0 0 0 
0 0 0 0 0 0 0 0 0 0 0 0 0 0 0 0 0 0 0 3 3 3 3 3 3 3 3 3 3 3 3 3 3 3 3 3 3 3 3 3 5 5 5 0 0 0 0 0 183 188 188 188 309 188 183 265 265 265 265 265 265 265 265 265 265 265 265 265 265 265 265 265 265 265 265 265 265 183 172 172 144 144 3 3 3 3 3 3 3 3 3 3 3 3 3 0 0 0 0 0 
0 0 0 0 0 0 0 0 0 0 0 0 0 0 0 0 0 0 0 3 3 3 3 3 3 3 3 3 3 3 3 3 3 3 3 3 3 3 3 3 5 5 5 0 0 0 0 0 183 188 188 188 309 188 183 265 265 265 265 265 265 265 265 265 265 265 265 265 265 265 265 265 265 265 265 265 265 183 144 144 3 3 3 3 3 3 3 3 3 3 3 3 3 3 0 0 0 0 0 0 
0 0 0 0 0 0 0 0 0 0 0 0 0 0 0 0 0 0 0 0 0 3 3 3 3 3 3 3 3 3 3 3 3 3 3 3 3 3 3 3 5 5 5 0 0 0 0 0 183 188 188 188 309 188 183 265 265 265 265 265 265 265 265 265 265 265 265 265 265 265 265 265 265 265 265 265 265 183 147 3 3 3 3 3 3 3 3 3 3 3 3 3 3 0 0 0 0 0 0 0 
0 0 0 0 0 0 0 0 0 0 0 0 0 0 0 0 0 0 0 0 0 0 0 3 3 3 3 3 3 3 3 3 3 3 3 3 3 3 3 3 3 3 5 5 0 0 0 0 183 188 188 188 309 188 183 265 265 265 265 265 265 265 265 265 265 265 265 265 265 265 265 265 265 265 265 265 265 183 147 3 3 3 3 3 3 3 3 3 3 3 3 3 0 0 0 0 0 0 0 0 
0 0 0 0 0 0 0 0 0 0 0 0 0 0 0 0 0 0 0 0 0 0 0 0 0 3 3 3 3 3 3 3 3 3 3 3 3 3 3 3 3 3 5 5 5 175 179 179 184 188 188 188 309 188 185 179 179 179 179 179 179 179 179 179 179 179 179 179 179 179 179 179 179 179 179 179 179 184 147 3 3 3 3 3 3 3 3 3 3 3 3 3 0 0 0 0 0 0 0 0 
0 0 0 0 0 0 0 0 0 0 0 0 0 0 0 0 0 0 0 0 0 0 0 0 0 0 0 3 3 3 3 3 3 3 3 3 3 3 3 3 3 3 5 5 5 173 173 173 173 188 188 188 309 188 171 171 171 171 194 171 171 171 171 171 171 171 321 323 324 322 171 171 171 171 171 171 171 171 147 3 3 3 3 3 3 3 3 3 3 3 3 0 0 0 0 0 0 0 0 0 
0 0 0 0 0 0 0 0 0 0 0 0 0 0 0 0 0 0 0 0 0 0 0 0 0 0 0 0 3 3 3 3 3 3 3 3 3 3 3 3 3 3 3 5 5 174 174 174 174 188 188 188 309 188 172 172 172 172 172 194 172 172 172 172 172 172 322 325 326 322 172 172 172 172 172 172 172 172 147 3 3 3 3 3 3 3 3 3 3 3 0 0 0 0 0 0 0 0 0 0 
0 0 0 0 0 0 0 0 0 0 0 0 0 0 0 0 0 0 0 0 0 0 0 0 0 0 0 0 0 0 0 3 3 3 3 3 3 3 3 3 3 3 3 5 5 392 390 392 188 188 188 188 309 188 188 188 188 188 188 188 188 188 188 188 188 188 188 309 309 188 188 188 5 144 144 144 144 144 155 3 3 3 3 3 3 3 3 3 3 0 0 0 0 0 0 0 0 0 0 0 
0 0 0 0 0 0 0 0 0 0 0 0 0 0 0 0 0 0 0 0 0 0 0 0 0 0 0 0 0 0 0 0 3 3 3 3 3 3 3 3 3 3 3 3 5 188 188 188 188 188 188 188 310 329 329 329 329 329 329 329 329 329 329 329 329 329 329 310 310 188 188 5 5 3 3 3 3 3 3 3 3 3 3 3 3 3 3 3 0 0 0 0 0 0 0 0 0 0 0 0 
0 0 0 0 0 0 0 0 0 0 0 0 0 0 0 0 0 0 0 0 0 0 0 0 0 0 0 0 0 0 0 0 0 0 3 3 3 3 3 3 3 3 3 3 5 391 188 188 188 362 364 366 368 370 188 188 188 188 188 188 188 188 188 188 188 188 188 188 188 188 5 5 3 3 3 3 3 3 3 3 3 3 3 3 3 3 3 0 0 0 0 0 0 0 0 0 0 0 0 0 
0 0 0 0 0 0 0 0 0 0 0 0 0 0 0 0 0 0 0 0 0 0 0 0 0 0 0 0 0 0 0 0 0 0 3 3 3 3 3 3 3 3 3 3 5 5 5 188 188 363 365 367 369 371 188 188 188 188 188 188 188 188 188 188 188 188 188 188 188 188 188 5 5 3 3 3 3 3 3 3 3 3 3 3 3 3 3 0 0 0 0 0 0 0 0 0 0 0 0 0 
0 0 0 0 0 0 0 0 0 0 0 0 0 0 0 0 0 0 0 0 0 0 0 0 0 0 0 0 0 0 0 0 0 0 3 3 3 3 3 3 3 3 3 3 3 3 5 188 188 188 188 188 188 188 15 16 188 188 188 188 188 188 188 188 5 5 5 5 5 5 5 5 3 3 3 3 3 3 3 3 3 3 3 3 0 0 0 0 0 0 0 0 0 0 0 0 0 0 0 0 
0 0 0 0 0 0 0 0 0 0 0 0 0 0 0 0 0 0 0 0 0 0 0 0 0 0 0 0 0 0 0 0 0 0 3 3 3 3 3 0 5 5 0 5 5 5 5 5 5 5 5 123 143 143 22 23 121 188 188 188 5 5 5 5 5 5 5 5 5 5 5 5 5 3 3 3 3 3 3 3 3 3 3 0 0 0 0 0 0 0 0 0 0 0 0 0 0 0 0 0 
0 0 0 0 0 0 0 0 0 0 0 0 0 0 0 0 0 0 0 0 0 0 0 0 0 0 0 0 0 0 0 0 0 0 3 3 3 3 3 5 5 5 5 5 5 5 0 5 5 5 0 0 0 0 0 120 121 5 5 5 5 5 5 5 5 5 5 5 3 3 3 3 3 3 3 3 3 3 3 3 3 0 0 0 0 0 0 0 0 0 0 0 0 0 0 0 0 0 0 0 
0 0 0 0 0 0 0 0 0 0 0 0 0 0 0 0 0 0 0 0 0 0 0 0 0 0 0 0 0 0 0 0 3 3 3 3 3 3 3 5 5 5 5 5 5 5 5 5 0 0 0 0 0 0 0 120 120 121 5 5 5 5 5 5 5 3 3 3 3 3 3 3 3 3 3 3 3 3 3 0 0 0 0 0 0 0 0 0 0 0 0 0 0 0 0 0 0 0 0 0 
0 0 0 0 0 0 0 0 0 0 0 0 0 0 0 0 0 0 0 0 0 0 0 0 0 0 0 0 0 0 0 0 3 3 3 3 3 3 3 3 3 3 3 5 5 0 0 0 0 0 0 389 389 0 0 0 121 121 5 5 5 5 5 5 5 5 3 3 3 3 3 3 3 3 3 3 0 0 0 0 0 0 0 0 0 0 0 0 0 0 0 0 0 0 0 0 0 0 0 0 
0 0 0 0 0 0 0 0 0 0 0 0 0 0 0 0 0 0 0 0 0 0 0 0 0 0 0 0 0 0 0 0 3 3 3 3 3 3 3 3 3 3 3 5 0 0 0 0 0 0 383 381 381 0 0 0 0 125 126 127 120 5 5 5 5 3 3 3 3 3 3 3 3 3 3 3 0 0 0 0 0 0 0 0 0 0 0 0 0 0 0 0 0 0 0 0 0 0 0 0 
0 0 0 0 0 0 0 0 0 0 0 0 0 0 0 0 0 0 0 0 0 0 0 0 0 0 0 0 0 0 0 0 0 3 3 3 3 3 3 3 3 3 3 5 0 0 0 0 0 0 383 381 382 0 0 0 0 0 121 121 120 0 5 5 5 3 3 3 3 3 3 3 3 3 3 0 0 0 0 0 0 0 0 0 0 0 0 0 0 0 0 0 0 0 0 0 0 0 0 0 
0 0 0 0 0 0 0 0 0 0 0 0 0 0 0 0 0 0 0 0 0 0 0 0 0 0 0 0 0 0 0 0 0 3 3 3 3 3 3 3 3 3 3 5 0 0 0 0 0 383 381 381 382 0 0 0 0 0 0 0 0 0 5 5 5 3 3 3 3 3 3 3 3 3 3 0 0 0 0 0 0 0 0 0 0 0 0 0 0 0 0 0 0 0 0 0 0 0 0 0 
0 0 0 0 0 0 0 0 0 0 0 0 0 0 0 0 0 0 0 0 0 0 0 0 0 0 0 0 0 0 0 0 0 0 3 3 3 3 3 3 3 3 3 5 5 0 0 0 0 383 381 381 382 0 0 0 0 0 0 0 0 0 0 0 5 3 3 3 3 3 3 3 3 3 0 0 0 0 0 0 0 0 0 0 0 0 0 0 0 0 0 0 0 0 0 0 0 0 0 0 
0 0 0 0 0 0 0 0 0 0 0 0 0 0 0 0 0 0 0 0 0 0 0 0 0 0 0 0 0 0 0 0 0 0 3 3 3 3 3 3 3 3 3 5 5 0 0 383 381 381 381 381 382 0 0 0 0 0 0 0 0 0 0 0 5 3 3 3 3 3 3 3 3 0 0 0 0 0 0 0 0 0 0 0 0 0 0 0 0 0 0 0 0 0 0 0 0 0 0 0 
0 0 0 0 0 0 0 0 0 0 0 0 0 0 0 0 0 0 0 0 0 0 0 0 0 0 0 0 0 0 0 0 0 0 3 3 3 3 3 3 3 3 3 3 5 0 0 386 385 381 381 381 382 0 0 0 0 0 0 0 0 0 5 5 5 3 3 3 3 3 3 3 3 0 0 0 0 0 0 0 0 0 0 0 0 0 0 0 0 0 0 0 0 0 0 0 0 0 0 0 
0 0 0 0 0 0 0 0 0 0 0 0 0 0 0 0 0 0 0 0 0 0 0 0 0 0 0 0 0 0 0 0 0 0 3 3 3 3 3 3 3 3 3 3 5 0 0 0 383 381 381 381 382 0 0 0 0 0 0 0 0 5 5 0 3 3 3 3 3 3 3 3 3 0 0 0 0 0 0 0 0 0 0 0 0 0 0 0 0 0 0 0 0 0 0 0 0 0 0 0 
0 0 0 0 0 0 0 0 0 0 0 0 0 0 0 0 0 0 0 0 0 0 0 0 0 0 0 0 0 0 0 0 0 0 3 3 3 3 3 3 3 3 3 3 5 5 0 0 383 381 381 382 382 0 0 0 0 0 0 0 0 5 5 5 3 3 3 3 3 3 3 3 0 0 0 0 0 0 0 0 0 0 0 0 0 0 0 0 0 0 0 0 0 0 0 0 0 0 0 0 
0 0 0 0 0 0 0 0 0 0 0 0 0 0 0 0 0 0 0 0 0 0 0 0 0 0 0 0 0 0 0 0 0 3 3 3 3 3 3 3 3 3 5 5 5 5 0 383 383 381 381 382 0 0 0 0 0 0 0 0 5 0 0 5 3 3 3 3 3 3 3 3 0 0 0 0 0 0 0 0 0 0 0 0 0 0 0 0 0 0 0 0 0 0 0 0 0 0 0 0 
0 0 0 0 0 0 0 0 0 0 0 0 0 0 0 0 0 0 0 0 0 0 0 0 0 0 0 0 0 0 0 0 0 3 3 3 3 3 3 3 3 3 5 5 0 0 0 383 381 381 381 382 0 0 0 0 0 0 0 0 5 0 5 5 3 3 3 3 3 3 3 3 0 0 0 0 0 0 0 0 0 0 0 0 0 0 0 0 0 0 0 0 0 0 0 0 0 0 0 0 
0 0 0 0 0 0 0 0 0 0 0 0 0 0 0 0 0 0 0 0 0 0 0 0 0 0 0 0 0 0 0 0 3 3 3 3 3 3 3 3 5 5 5 5 0 0 0 383 381 381 381 382 0 0 0 0 0 0 0 0 5 0 5 3 3 3 3 3 3 3 3 3 0 0 0 0 0 0 0 0 0 0 0 0 0 0 0 0 0 0 0 0 0 0 0 0 0 0 0 0 
0 0 0 0 0 0 0 0 0 0 0 0 0 0 0 0 0 0 0 0 0 0 0 0 0 0 0 0 0 0 0 3 3 3 3 3 3 3 3 3 5 5 5 0 0 0 383 381 381 381 381 382 0 0 0 0 0 0 0 0 5 5 5 3 3 3 3 3 3 3 3 3 0 0 0 0 0 0 0 0 0 0 0 0 0 0 0 0 0 0 0 0 0 0 0 0 0 0 0 0 
0 0 0 0 0 0 0 0 0 0 0 0 0 0 0 0 0 0 0 0 0 0 0 0 0 0 0 0 0 0 0 3 3 3 3 3 3 3 3 3 3 5 0 0 0 383 381 381 381 381 381 382 0 0 0 0 0 0 0 5 5 5 3 3 3 3 3 3 3 3 3 3 0 0 0 0 0 0 0 0 0 0 0 0 0 0 0 0 0 0 0 0 0 0 0 0 0 0 0 0 
0 0 0 0 0 0 0 0 0 0 0 0 0 0 0 0 0 0 0 0 0 0 0 0 0 0 0 0 0 0 0 0 3 3 3 3 3 3 3 3 3 5 5 0 0 383 381 381 381 382 385 0 0 0 0 0 0 0 5 5 5 5 3 3 3 3 3 3 3 3 3 0 0 0 0 0 0 0 0 0 0 0 0 0 0 0 0 0 0 0 0 0 0 0 0 0 0 0 0 0 
0 0 0 0 0 0 0 0 0 0 0 0 0 0 0 0 0 0 0 0 0 0 0 0 0 0 0 0 0 0 0 0 3 3 3 3 3 3 3 3 3 5 0 0 0 383 381 381 381 382 0 0 0 0 0 0 0 0 5 0 5 3 3 3 3 3 3 3 3 3 3 0 0 0 0 0 0 0 0 0 0 0 0 0 0 0 0 0 0 0 0 0 0 0 0 0 0 0 0 0 
0 0 0 0 0 0 0 0 0 0 0 0 0 0 0 0 0 0 0 0 0 0 0 0 0 0 0 0 0 0 0 0 3 3 3 3 3 3 3 3 5 5 0 0 0 383 381 381 381 382 0 0 0 0 0 0 0 0 5 5 5 3 3 3 3 3 3 3 3 3 3 0 0 0 0 0 0 0 0 0 0 0 0 0 0 0 0 0 0 0 0 0 0 0 0 0 0 0 0 0 
0 0 0 0 0 0 0 0 0 0 0 0 0 0 0 0 0 0 0 0 0 0 0 0 0 0 0 0 0 0 0 0 3 3 3 3 3 3 3 3 5 5 0 0 0 383 381 381 381 382 0 0 0 0 0 0 0 0 5 5 5 3 3 3 3 3 3 3 3 3 3 0 0 0 0 0 0 0 0 0 0 0 0 0 0 0 0 0 0 0 0 0 0 0 0 0 0 0 0 0 
0 0 0 0 0 0 0 0 0 0 0 0 0 0 0 0 0 0 0 0 0 0 0 0 0 0 0 0 0 0 0 0 3 3 3 3 3 3 3 5 5 5 0 0 0 383 381 381 382 0 0 0 0 0 0 0 0 0 5 5 5 3 3 3 3 3 3 3 3 3 3 0 0 0 0 0 0 0 0 0 0 0 0 0 0 0 0 0 0 0 0 0 0 0 0 0 0 0 0 0 
0 0 0 0 0 0 0 0 0 0 0 0 0 0 0 0 0 0 0 0 0 0 0 0 0 0 0 0 0 0 0 3 3 3 3 3 3 3 3 5 5 5 0 0 0 383 381 381 382 0 0 0 0 0 0 0 5 5 5 3 3 3 3 3 3 3 3 3 3 3 3 0 0 0 0 0 0 0 0 0 0 0 0 0 0 0 0 0 0 0 0 0 0 0 0 0 0 0 0 0 
0 0 0 0 0 0 0 0 0 0 0 0 0 0 0 0 0 0 0 0 0 0 0 0 0 0 0 0 0 0 0 3 3 3 3 3 3 3 3 3 5 5 0 0 0 383 381 382 0 0 0 0 0 0 0 0 5 5 3 3 3 3 3 3 3 3 3 3 3 3 0 0 0 0 0 0 0 0 0 0 0 0 0 0 0 0 0 0 0 0 0 0 0 0 0 0 0 0 0 0 
0 0 0 0 0 0 0 0 0 0 0 0 0 0 0 0 0 0 0 0 0 0 0 0 0 0 0 0 0 0 0 3 3 3 3 3 3 3 3 3 3 5 0 0 383 381 381 382 0 0 0 0 0 0 0 0 5 5 5 5 3 3 3 3 3 3 3 3 3 3 0 0 0 0 0 0 0 0 0 0 0 0 0 0 0 0 0 0 0 0 0 0 0 0 0 0 0 0 0 0 
0 0 0 0 0 0 0 0 0 0 0 0 0 0 0 0 0 0 0 0 0 0 0 0 0 0 0 0 0 0 0 3 3 3 3 3 3 3 3 3 148 5 0 0 383 381 381 382 388 0 0 0 0 0 0 5 5 5 5 3 3 3 3 3 3 3 3 3 3 3 3 0 0 0 0 0 0 0 0 0 0 0 0 0 0 0 0 0 0 0 0 0 0 0 0 0 0 0 0 0 
0 0 0 0 0 0 0 0 0 0 0 0 0 0 0 0 0 0 0 0 0 0 0 0 0 0 0 0 0 0 0 0 3 3 3 3 3 3 3 3 148 5 5 0 0 385 383 383 382 103 103 103 103 103 103 5 5 5 5 3 3 3 3 3 3 3 3 3 3 3 3 0 0 0 0 0 0 0 0 0 0 0 0 0 0 0 0 0 0 0 0 0 0 0 0 0 0 0 0 0 
0 0 0 0 0 0 0 0 0 0 0 0 0 0 0 0 0 0 0 0 0 0 0 0 0 0 0 0 0 0 0 3 3 3 3 3 3 3 3 3 3 148 5 5 0 104 387 2 2 2 2 2 2 2 2 103 103 103 103 167 3 3 3 3 3 3 3 3 3 3 3 3 0 0 0 0 0 0 0 0 0 0 0 0 0 0 0 0 0 0 0 0 0 0 0 0 0 0 0 0 
0 0 0 0 0 0 0 0 0 0 0 0 0 0 0 0 0 0 0 0 0 0 0 0 0 0 0 0 0 0 0 3 3 3 3 3 3 3 3 3 3 3 148 5 5 102 2 2 2 2 2 2 2 2 2 2 2 2 2 161 3 3 3 3 3 3 3 3 3 3 3 3 3 0 0 0 0 0 0 0 0 0 0 0 0 0 0 0 0 0 0 0 0 0 0 0 0 0 0 0 
0 0 0 0 0 0 0 0 0 0 0 0 0 0 0 0 0 0 0 0 0 0 0 0 0 0 0 0 0 0 3 3 3 3 3 3 3 3 3 3 3 3 148 5 5 5 2 2 2 2 2 2 2 2 2 2 2 2 2 161 3 3 3 3 3 3 3 3 3 3 3 3 3 0 0 0 0 0 0 0 0 0 0 0 0 0 0 0 0 0 0 0 0 0 0 0 0 0 0 0 
0 0 0 0 0 0 0 0 0 0 0 0 0 0 0 0 0 0 0 0 0 0 0 0 0 0 0 0 0 0 3 3 3 3 3 3 3 3 3 3 3 3 148 5 5 102 2 2 2 2 2 2 2 2 2 2 2 2 166 163 167 3 3 3 3 3 3 3 3 3 3 3 0 0 0 0 0 0 0 0 0 0 0 0 0 0 0 0 0 0 0 0 0 0 0 0 0 0 0 0 
0 0 0 0 0 0 0 0 0 0 0 0 0 0 0 0 0 0 0 0 0 0 0 0 0 0 0 0 0 0 0 3 3 3 3 3 3 3 3 3 3 3 148 5 5 102 2 2 2 2 2 2 2 2 2 2 2 2 2 2 161 3 3 3 3 3 3 3 3 3 3 3 0 0 0 0 0 0 0 0 0 0 0 0 0 0 0 0 0 0 0 0 0 0 0 0 0 0 0 0 
0 0 0 0 0 0 0 0 0 0 0 0 0 0 0 0 0 0 0 0 0 0 0 0 0 0 0 0 0 0 0 3 3 3 3 3 3 3 3 3 3 3 3 148 5 102 2 2 2 2 2 2 2 2 2 2 2 2 2 2 161 3 3 3 3 3 3 3 3 3 3 3 0 0 0 0 0 0 0 0 0 0 0 0 0 0 0 0 0 0 0 0 0 0 0 0 0 0 0 0 
0 0 0 0 0 0 0 0 0 0 0 0 0 0 0 0 0 0 0 0 0 0 0 0 0 0 0 0 0 0 0 0 3 3 3 3 3 3 3 3 3 3 3 148 5 5 2 2 2 2 2 2 2 2 2 2 2 2 2 159 169 3 3 3 3 3 3 3 3 3 3 3 0 0 0 0 0 0 0 0 0 0 0 0 0 0 0 0 0 0 0 0 0 0 0 0 0 0 0 0 
0 0 0 0 0 0 0 0 0 0 0 0 0 0 0 0 0 0 0 0 0 0 0 0 0 0 0 0 0 0 0 0 0 3 3 3 3 3 3 3 3 3 3 148 5 5 2 2 2 2 2 2 2 2 2 2 2 2 2 161 3 3 3 3 3 3 3 3 3 3 3 3 0 0 0 0 0 0 0 0 0 0 0 0 0 0 0 0 0 0 0 0 0 0 0 0 0 0 0 0 
0 0 0 0 0 0 0 0 0 0 0 0 0 0 0 0 0 0 0 0 0 0 0 0 0 0 0 0 0 0 0 0 0 3 3 3 3 3 3 3 3 3 3 148 5 2 2 2 2 2 2 2 2 2 2 2 2 2 2 161 3 3 3 3 3 3 3 3 3 3 3 0 0 0 0 0 0 0 0 0 0 0 0 0 0 0 0 0 0 0 0 0 0 0 0 0 0 0 0 0 
0 0 0 0 0 0 0 0 0 0 0 0 0 0 0 0 0 0 0 0 0 0 0 0 0 0 0 0 0 0 0 0 0 0 3 3 3 3 3 3 3 3 3 154 144 158 158 158 158 158 158 158 158 158 158 158 158 158 158 169 3 3 3 3 3 3 3 3 3 3 0 0 0 0 0 0 0 0 0 0 0 0 0 0 0 0 0 0 0 0 0 0 0 0 0 0 0 0 0 0 
3 3 3 3 3 3 3 3 3 3 3 3 3 3 3 3 3 3 3 3 3 3 3 3 3 3 3 3 3 3 3 3 3 3 3 3 3 3 3 3 3 3 3 3 3 3 3 3 3 3 3 3 3 3 3 3 3 3 3 3 3 3 3 3 3 3 3 3 3 3 3 3 3 3 3 3 3 3 3 3 3 3 3 3 3 3 3 3 3 3 3 3 3 3 3 3 3 3 3 3 
3 3 3 3 3 3 3 3 3 3 3 3 3 3 3 3 3 3 3 3 3 3 3 3 3 3 3 3 3 3 3 3 3 3 3 3 3 3 3 3 3 3 3 3 3 3 3 3 3 3 3 3 3 3 3 3 3 3 3 3 3 3 3 3 3 3 3 3 3 3 3 3 3 3 3 3 3 3 3 3 3 3 3 3 3 3 3 3 3 3 3 3 3 3 3 3 3 3 3 3 
3 3 3 3 3 3 3 3 3 3 3 3 3 3 3 3 3 3 3 3 3 3 3 3 3 3 3 3 3 3 3 3 3 3 3 3 3 3 3 3 3 3 3 3 3 3 3 3 3 3 3 3 3 3 3 3 3 3 3 3 3 3 3 3 3 3 3 3 3 3 3 3 3 3 3 3 3 3 3 3 3 3 3 3 3 3 3 3 3 3 3 3 3 3 3 3 3 3 3 3 
3 3 3 3 3 3 3 3 3 3 3 3 3 3 3 3 3 3 3 3 3 3 3 3 3 3 3 3 3 3 3 3 3 3 3 3 3 3 3 3 3 3 3 3 3 3 3 3 3 3 3 3 3 3 3 3 3 3 3 3 3 3 3 3 3 3 3 3 3 3 3 3 3 3 3 3 3 3 3 3 3 3 3 3 3 3 3 3 3 3 3 3 3 3 3 3 3 3 3 3 
3 3 3 3 3 3 3 3 3 3 3 3 3 3 3 3 3 3 3 3 3 3 3 3 3 3 3 3 3 3 3 3 3 3 3 3 3 3 3 3 3 3 3 3 3 3 3 3 3 3 3 3 3 3 3 3 3 3 3 3 3 3 3 3 3 3 3 3 3 3 3 3 3 3 3 3 3 3 3 3 3 3 3 3 3 3 3 3 3 3 3 3 3 3 3 3 3 3 3 3 
3 3 3 3 3 3 3 3 3 3 3 3 3 3 3 3 3 3 3 3 3 3 3 3 3 3 3 3 3 3 3 3 3 3 3 3 3 3 3 3 3 3 3 3 3 3 3 3 3 3 3 3 3 3 3 3 3 3 3 3 3 3 3 3 3 3 3 3 3 3 3 3 3 3 3 3 3 3 3 3 3 3 3 3 3 3 3 3 3 3 3 3 3 3 3 3 3 3 3 3 
